111111111111111111111111111111111
1P0000000000000000000000000000001
1000000C000000000C000000000000001
100000000011000000000000000000001
100000000000000000000000000000001
100000000000000000000000000000001
100000000000000000000000000000001
100000000000000000000000000000001
100000000000000000000000000000001
100000000011000000000000000000001
100000000000000000000000000000001
100000000000001100000000000000001
100E00000000C0110C000000000000001
111111111111111111111111111111111
